24	T UW F OW R
AFTER	AE F T ER
ALL	AO L
BEFORE	B IH F AO R
BEFORE(2)	B IY F AO R
DANCE	D AE N S
DAY	D EY
FIRE	F AY ER
FIRE(2)	F AY R
FIREWORKS	F AY R W ER K S
FIVE	F AY V
GALAXY	G AE L AH K S IY
HOUR	AW ER
HOUR(2)	AW R
ICE	AY S
IS	IH Z
IT	IH T
KILL	K IH L
LIGHT	L AY T
LIGHTS	L AY T S
MOON	M UW N
MUSIC	M Y UW Z IH K
PHASE	F EY Z
PITCH	P IH CH
PROCESS	P R AA S EH S
PROCESS(2)	P R AO S EH S
RAIN	R EY N
RAINBOW	R EY N B OW
REACT	R IY AE K T
SNOW	S N OW
SPEED	S P IY D
STOP	S T AA P
SUN	S AH N
SUNNY	S AH N IY
TEN	T EH N
THE	DH AH
THE(2)	DH IY
THREE	TH R IY
TODAY	T AH D EY
TODAY(2)	T UW D EY
TOMORROW	T AH M AA R OW
TOMORROW(2)	T UW M AA R OW
TWENTY	T W EH N T IY
WEATHER	W EH DH ER
WHAT	W AH T
WHAT(2)	HH W AH T
WHAT'S	W AH T S
WHAT'S(2)	HH W AH T S
WHOLE	HH OW L
WILL	W IH L
WILL(2)	W AH L
WIND	W AY N D
WIND(2)	W IH N D
